1111111111111111111111
1000000000000000000001
1010111111111111110101
1010111111111111110101
1010000000000000000101
1010111011331101110101
101015001RSO2100510101
1010111011111101110101
1500000000000000000051
1101011111001111101011
0001011111001111101000
0001000000000000001000
1101011111001111101011
1500000000000000000051
1011111011111101111101
1010000000000000000101
1010111011001101110101
1010151011001101510101
1010001011P01101000101
1011111011111101111101
1000000000000000000001
1111111111111111111111
--




